wal wal wal ... ... ... ... ... wal wal wal wal wal wal wal ... ... ... ... ... ... ... ... ... ... ... ... ... ... ... ... ... ... ... ... 
wal wal wal ... ... ... ... ... wal wal wal wal wal wal wal wal wal wal wal wal wal wal wal wal wal wal wal wal wal wal wal wal wal wal wal 
... Lvs lvs ... ... ... ... ... lvo Lvo ... ... ... ... ... ... ... ... ... ... ... ... ... ... ... ... ... ... ... ... ... ... ... ... ... 
$$p Lvm lvm ... ... ... ... ... wal wal ... ... ... ... #ne ... ... ... ... ... ... ... ... ... ... ... ... ... ... ... ... ... ... $$p ... 
... Lve lve ... ... ... ... ... ... ... ... ... ... ... ... ... ... ... ... ... ... ... ... ... ... ... ... ... ... ... ... ... ... ... ... 
... wal wal ... ... ... ... ... wal wal wal wal ... ... wal ... ... ... ... wal wal wal wal wal wal wal wal wal wal wal wal wal wal wal wal 
... wal wal ... ... ... ... ... wal ... ... wal ... ... wal Lhs Lhm Lhm Lhe wal ... ... ... ... ... ... ... ... ... ... ... ... ... ... ... 
... wal wal ... ... ... ... ... wal ... ... wal ... ... wal lhs lhm lhm lhe wal ... ... ... ... ... ... ... ... ... ... ... ... ... ... ... 
... wal wal ... ... ... ... ... wal ... ... wal ... ... wal ... ... ... ... wal ... ... ... ... ... ... ... ... ... ... ... ... ... ... ... 
... ... ... ... ... ... ... ... wal ... ... wal ... ... wal ... ... wal Lho wal ... ... ... ... ... ... ... ... ... ... ... ... ... ... ... 
... ... ... ... ... ... ... ... wal ... ... wal ... ... wal ... ... wal lho wal ... ... ... ... ... ... ... ... ... ... ... ... ... ... ... 
wal wal wal wal wal wal wal wal wal ... ... wal ... ... ... ... ... ... ... wal ... ... ... ... ... ... ... ... ... ... ... ... ... ... ... 
... ... ... ... ... ... ... ... ... ... ... wal ... ... ... ... ... ... ... wal ... ... ... ... ... ... ... ... ... ... ... ... ... ... ... 
... ... ... ... ... ... ... ... ... ... ... wal wal wal wal wal wal wal wal wal ... ... ... ... ... ... ... ... ... ... ... ... ... ... ... 
... ... ... ... ... ... ... ... ... ... ... ... ... ... ... ... ... ... ... ... ... ... ... ... ... ... ... ... ... ... ... ... ... ... ... 
... ... ... ... ... ... ... ... ... ... ... ... ... ... ... ... ... wal ... ... ... ... ... ... ... ... ... ... ... ... ... ... ... ... ... 
... ... ... ... ... ... ... ... ... ... ... ... ... ... ... ... ... wal ... ... ... ... ... ... ... ... ... ... ... ... ... ... ... ... ... 
... ... ... ... ... ... ... ... ... ... ... ... ... ... ... ... wal ... wal ... ... ... ... ... ... ... ... ... ... ... ... ... ... ... ... 
... ... ... ... ... ... ... ... ... ... ... ... ... ... ... ... ... ... ... ... ... ... ... ... ... ... ... ... ... ... ... ... ... ... ... 
... ... ... ... ... ... ... ... ... ... ... ... ... ... ... ... ... ... ... ... ... ... ... ... ... ... ... ... ... ... ... ... ... ... ... 
... ... ... ... wal ... ... ... wal ... ... wal ... ... ... ... ... ... ... ... ... ... ... ... ... ... ... ... ... ... ... ... ... ... ... 
... ... ... ... wal ... ... wal ... wal ... wal ... ... ... ... ... ... ... ... ... ... ... ... ... ... ... ... ... ... ... ... ... ... ... 
... ... ... ... ... wal ... ... wal ... ... ... wal ... ... ... ... ... ... ... ... ... ... ... ... ... ... ... ... ... ... ... ... ... ... 
... ... ... ... ... ... ... ... ... ... ... ... ... ... ... ... ... ... ... ... ... ... ... ... ... ... ... ... ... ... ... ... ... ... ... 
... ... wal wal wal wal wal ... wal ... ... ... wal ... ... wal wal wal ... ... wal ... ... ... wal ... ... ... ... ... ... ... ... ... ... 
... ... wal ... ... ... ... ... wal ... ... ... wal ... wal ... ... ... wal ... wal ... ... ... wal ... ... ... ... ... ... ... ... ... ... 
... ... wal wal wal ... ... ... wal ... ... ... wal ... wal ... ... ... ... ... wal wal wal wal ... ... ... ... ... ... ... ... ... ... ... 
... ... wal ... ... ... ... ... wal ... ... ... wal ... wal ... ... ... ... ... wal ... ... ... wal ... ... ... ... ... ... ... ... ... ... 
... ... wal ... ... ... ... ... wal ... ... ... wal ... wal ... ... ... ... ... wal ... ... ... wal ... ... ... ... ... ... ... ... ... ... 
... ... wal ... ... ... ... ... wal ... ... ... wal ... wal ... ... ... wal ... wal ... ... ... wal ... ... ... ... ... ... ... ... ... ... 
... ... wal ... ... ... ... ... ... wal wal wal ... ... ... wal wal wal ... ... wal ... ... ... wal ... ... ... ... ... ... ... ... ... ... 
... ... ... ... ... ... ... ... ... ... ... ... ... ... ... ... ... ... ... ... ... ... ... ... ... ... ... ... ... ... ... ... ... ... ... 
... ... wal wal wal wal wal wal wal wal wal wal wal wal wal wal wal wal wal wal wal wal wal wal wal ... ... ... ... ... ... ... ... ... ... 
... ... ... ... ... ... ... ... ... ... ... ... ... ... ... ... ... ... ... ... ... ... ... ... ... ... ... ... ... ... ... ... ... ... ... 
... ... ... ... ... ... ... ... ... ... ... ... ... ... ... ... ... ... ... ... ... ... ... ... ... ... ... ... ... ... ... ... ... ... ... 
